aaaaaaaaaaaaaaaaaa
a0000000000000000a
a000000000000c000a
a00hh000000000000a
a0000h0000000h000a
a000000rrrrr00000a
a0rrrrrrp00rrrrr0a
a0000000000r00000a
a0hhh000000rhh000a
a0000000000rhh000a
a00000hh000r00000a
a0000000000r00000a
aaaaaaaaaaa0aaaaaa
